10.ox
.o..ooo.o.
o.....o..o
o.o..o..o.
...o....o.
ooo.o..o..
ooo.....o.
.ooo.o.o..
....oo.oo.
..ooo...oo
..o..ooooo
